Country/Territory,Region,Status,PR rating,CL rating,PR,CL,Total
Cambodia,Asia,NF,7,5,5,19,24
Niger,Africa,PF,4,4,21,28,49
Slovakia,Europe,F,1,1,37,53,90
Northern Cyprus,Europe,F,2,2,31,50,81
Fiji,Asia,PF,3,3,27,35,62
Libya,Africa,NF,7,6,1,8,9
San Marino,Europe,F,1,1,38,57,95
Suriname,Americas,F,2,3,32,43,75
United States,Americas,F,2,1,33,53,86
United States,Americas,F,1,1,37,55,92
Argentina,Americas,F,2,2,31,49,80
Portugal,Europe,F,1,1,39,58,97
Germany,Europe,F,1,1,39,57,96
Bahrain,Middle East,NF,6,6,6,10,16
North Macedonia,Europe,PF,3,3,27,39,66
Croatia,Europe,F,1,2,36,49,85
Gaza Strip,Middle East,NF,7,6,3,8,11
North Macedonia,Europe,PF,4,3,23,37,60
South Ossetia,Eurasia,NF,7,6,2,9,11
Kiribati,Asia,F,1,1,37,56,93
St. Kitts and Nevis,Americas,F,1,1,36,53,89
Moldova,Eurasia,PF,3,4,24,34,58
Papua New Guinea,Asia,PF,4,3,23,39,62
Kazakhstan,Eurasia,NF,7,5,5,18,23
Honduras,Americas,PF,4,4,20,26,46
Hong Kong,Asia,PF,5,2,16,51,67
Bahrain,Middle East,NF,7,6,2,10,12
Iran,Middle East,NF,6,6,7,11,18
Dominican Republic,Americas,PF,3,3,26,41,67
Zambia,Africa,PF,4,4,23,33,56
Malawi,Africa,PF,3,3,26,38,64
Dominica,Americas,F,1,1,37,56,93
Nicaragua,Americas,PF,4,3,19,35,54
Paraguay,Americas,PF,3,3,28,37,65
Ethiopia,Africa,NF,6,6,10,14,24
Mauritania,Africa,NF,6,5,9,21,30
Andorra,Europe,F,1,1,39,56,95
Tibet,Asia,NF,7,7,-2,3,1
Marshall Islands,Asia,F,1,1,38,55,93
Kuwait,Middle East,PF,5,5,16,23,39
Portugal,Europe,F,1,1,39,57,96
Malaysia,Asia,PF,4,4,19,27,46
Jordan,Middle East,NF,6,5,11,23,34
Uruguay,Americas,F,1,1,40,58,98
Uruguay,Americas,F,1,1,40,58,98
Botswana,Africa,F,3,2,28,44,72
Kazakhstan,Eurasia,NF,7,5,5,17,22
Israel,Middle East,F,1,2,36,44,80
Congo (Kinshasa),Africa,NF,6,6,9,11,20
Finland,Europe,F,1,1,40,60,100
Congo (Brazzaville),Africa,NF,6,5,7,23,30
Luxembourg,Europe,F,1,1,38,59,97
Andorra,Europe,F,1,1,39,57,96
Central African Republic,Africa,NF,7,7,4,6,10
Albania,Europe,PF,3,3,28,40,68
Kuwait,Middle East,PF,5,5,13,23,36
Sudan,Africa,NF,7,6,0,10,10
Nauru,Asia,F,2,2,35,46,81
San Marino,Europe,F,1,1,38,59,97
Mongolia,Asia,F,1,2,36,50,86
Ecuador,Americas,PF,3,3,24,36,60
Lebanon,Middle East,PF,5,4,14,30,44
Myanmar,Asia,NF,7,6,0,9,9
Dominican Republic,Americas,PF,3,3,26,41,67
Liberia,Africa,PF,3,3,27,35,62
Tanzania,Africa,PF,5,5,17,23,40
The Gambia,Africa,PF,4,4,20,26,46
Nicaragua,Americas,NF,6,5,10,22,32
Barbados,Americas,F,1,1,40,59,99
Congo (Brazzaville),Africa,NF,7,6,2,15,17
Cote d'Ivoire,Africa,PF,4,4,19,32,51
Malaysia,Asia,PF,4,4,19,28,47
Turkey,Europe,PF,4,5,18,20,38
Morocco,Africa,PF,5,5,13,24,37
Maldives,Asia,PF,4,5,18,22,40
United Kingdom,Europe,F,1,1,39,54,93
Tuvalu,Asia,F,1,1,37,56,93
Haiti,Americas,PF,5,5,17,24,41
Singapore,Asia,PF,4,4,19,32,51
Papua New Guinea,Asia,PF,4,3,23,41,64
South Korea,Asia,F,2,2,35,50,85
Marshall Islands,Asia,F,1,1,38,55,93
Myanmar,Asia,NF,5,6,14,16,30
Cabo Verde,Africa,F,1,1,37,53,90
Equatorial Guinea,Africa,NF,7,7,0,5,5
Western Sahara,Africa,NF,7,7,-3,7,4
Honduras,Americas,PF,4,4,20,29,49
St. Kitts and Nevis,Americas,F,2,1,35,53,88
Germany,Europe,F,1,1,39,55,94
Estonia,Europe,F,1,1,38,56,94
Trinidad and Tobago,Americas,F,2,2,33,48,81
Guyana,Americas,F,2,3,31,43,74
Rwanda,Africa,NF,6,6,9,14,23
Mozambique,Africa,PF,4,3,23,35,58
Eritrea,Africa,NF,7,7,1,2,3
Guyana,Americas,F,2,3,32,42,74
Canada,Americas,F,1,1,39,59,98
Slovakia,Europe,F,1,1,36,53,89
Monaco,Europe,F,3,1,26,57,83
Moldova,Eurasia,PF,3,3,29,36,65
Maldives,Asia,PF,4,4,20,28,48
Syria,Middle East,NF,7,7,-3,2,-1
Poland,Europe,F,1,1,38,55,93
Latvia,Europe,F,2,2,33,51,84
United Kingdom,Europe,F,1,1,39,55,94
Lesotho,Africa,PF,3,3,27,37,64
Slovakia,Europe,F,1,1,36,53,89
Cabo Verde,Africa,F,1,1,37,53,90
Namibia,Africa,F,2,2,30,47,77
Turkmenistan,Eurasia,NF,7,7,1,6,7
United States,Americas,F,2,1,33,53,86
Panama,Americas,F,2,2,35,47,82
Argentina,Americas,F,2,2,34,50,84
Saudi Arabia,Middle East,NF,7,7,1,6,7
Slovenia,Europe,F,1,1,39,55,94
Ethiopia,Africa,NF,7,6,4,8,12
Paraguay,Americas,PF,3,3,27,37,64
Costa Rica,Americas,F,1,1,38,53,91
Nepal,Asia,PF,3,4,25,29,54
Yemen,Middle East,NF,7,6,4,13,17
Fiji,Asia,PF,6,4,7,30,37
Netherlands,Europe,F,1,1,40,59,99
Pakistani Kashmir,Asia,NF,6,5,8,21,29
Malaysia,Asia,PF,4,4,21,30,51
Peru,Americas,F,2,3,30,42,72
Transnistria,Eurasia,NF,6,6,10,14,24
Japan,Asia,F,1,1,40,56,96
Angola,Africa,NF,6,5,11,19,30
Canada,Americas,F,1,1,40,59,99
North Korea,Asia,NF,7,7,0,3,3
Tonga,Asia,F,2,2,30,49,79
Indian Kashmir,Asia,PF,4,4,22,29,51
Indonesia,Asia,PF,2,4,30,29,59
Austria,Europe,F,1,1,37,57,94
Liechtenstein,Europe,F,2,1,33,57,90
Finland,Europe,F,1,1,40,60,100
Panama,Americas,F,2,2,35,48,83
Palau,Asia,F,1,1,37,55,92
Albania,Europe,PF,3,3,28,39,67
Thailand,Asia,PF,4,4,22,32,54
New Zealand,Asia,F,1,1,40,59,99
Iraq,Middle East,NF,5,6,12,15,27
El Salvador,Americas,PF,2,4,30,33,63
South Africa,Africa,F,2,2,33,46,79
Finland,Europe,F,1,1,40,60,100
Benin,Africa,PF,4,2,21,45,66
Fiji,Asia,PF,3,3,24,36,60
Chad,Africa,NF,7,6,3,14,17
Lithuania,Europe,F,1,1,38,53,91
Togo,Africa,PF,5,4,16,28,44
Dominica,Americas,F,1,1,38,57,95
Spain,Europe,F,1,1,38,54,92
West Bank,Middle East,NF,7,5,4,21,25
France,Europe,F,1,2,38,52,90
Central African Republic,Africa,NF,7,7,1,6,7
Congo (Kinshasa),Africa,NF,7,6,5,15,20
Venezuela,Americas,NF,7,6,1,13,14
Northern Cyprus,Europe,F,2,2,32,48,80
United Arab Emirates,Middle East,NF,6,6,8,13,21
Lesotho,Africa,PF,3,3,27,36,63
Antigua and Barbuda,Americas,F,2,2,31,49,80
Angola,Africa,NF,6,5,10,18,28
Angola,Africa,NF,6,5,11,21,32
Norway,Europe,F,1,1,40,60,100
Burkina Faso,Africa,PF,6,3,9,36,45
Uruguay,Americas,F,1,1,40,58,98
Venezuela,Americas,PF,5,5,15,20,35
Jamaica,Americas,F,2,3,34,40,74
Georgia,Eurasia,PF,3,3,27,37,64
Greece,Europe,F,2,2,35,48,83
Madagascar,Africa,PF,3,3,26,35,61
Bolivia,Americas,PF,3,3,28,39,67
Myanmar,Asia,PF,5,5,13,17,30
Tanzania,Africa,PF,5,5,12,22,34
Spain,Europe,F,1,1,37,53,90
Bhutan,Asia,PF,3,4,29,30,59
Dominica,Americas,F,1,1,37,56,93
Pakistan,Asia,PF,4,5,20,22,42
Lesotho,Africa,F,2,3,31,41,72
Ukraine,Eurasia,PF,3,3,26,36,62
Pakistani Kashmir,Asia,NF,6,5,9,19,28
Finland,Europe,F,1,1,40,60,100
United Kingdom,Europe,F,1,1,40,57,97
Switzerland,Europe,F,1,1,39,57,96
Venezuela,Americas,NF,6,5,8,18,26
Slovakia,Europe,F,1,1,37,53,90
Bahamas,Americas,F,1,1,38,53,91
St. Lucia,Americas,F,1,1,38,54,92
Gaza Strip,Middle East,NF,7,6,3,9,12
Benin,Africa,F,2,2,32,47,79
Ghana,Africa,F,1,2,37,46,83
Latvia,Europe,F,1,2,37,52,89
Nagorno-Karabakh,Eurasia,PF,5,5,16,19,35
Thailand,Asia,NF,7,5,5,25,30
Rwanda,Africa,NF,6,5,9,17,26
Jordan,Middle East,PF,5,5,12,25,37
Iran,Middle East,NF,6,6,6,10,16
Barbados,Americas,F,1,1,38,57,95
Tajikistan,Eurasia,NF,6,6,8,16,24
Luxembourg,Europe,F,1,1,39,60,99
Tonga,Asia,F,2,2,31,44,75
Pakistan,Asia,PF,4,5,21,21,42
Russia,Eurasia,NF,7,6,5,15,20
Madagascar,Africa,PF,4,4,22,30,52
Latvia,Europe,F,2,2,34,51,85
Cuba,Americas,NF,7,6,1,13,14
Cuba,Americas,NF,7,6,1,13,14
United States,Americas,F,2,2,32,51,83
Costa Rica,Americas,F,1,1,37,53,90
Chad,Africa,NF,7,6,5,16,21
St. Lucia,Americas,F,1,1,39,53,92
Poland,Europe,F,1,1,38,55,93
Russia,Eurasia,NF,7,6,5,15,20
Sri Lanka,Asia,PF,4,4,23,33,56
Burundi,Africa,NF,7,6,4,14,18
Cote d'Ivoire,Africa,PF,5,4,17,29,46
Eswatini,Africa,NF,7,5,1,17,18
Switzerland,Europe,F,1,1,39,57,96
Samoa,Asia,F,2,2,30,51,81
Central African Republic,Africa,NF,7,7,0,6,6
Crimea,Eurasia,NF,7,6,-2,9,7
Togo,Africa,PF,4,4,18,29,47
Gabon,Africa,NF,7,5,3,19,22
Pakistan,Asia,PF,4,5,21,22,43
Liberia,Africa,PF,3,4,27,33,60
Montenegro,Europe,F,3,2,27,45,72
Zimbabwe,Africa,NF,6,5,10,20,30
Benin,Africa,F,2,2,33,49,82
Malawi,Africa,PF,3,3,29,37,66
Guinea,Africa,PF,5,5,17,24,41
Hong Kong,Asia,PF,5,3,16,39,55
Uruguay,Americas,F,1,1,39,58,97
New Zealand,Asia,F,1,1,40,58,98
Cote d'Ivoire,Africa,PF,4,4,19,32,51
Germany,Europe,F,1,1,39,57,96
Oman,Middle East,NF,6,5,8,17,25
Bulgaria,Europe,F,2,2,31,47,78
Monaco,Europe,F,2,1,31,56,87
Nigeria,Africa,PF,4,4,20,26,46
Georgia,Eurasia,PF,3,3,24,36,60
Armenia,Eurasia,PF,5,4,16,30,46
Guinea,Africa,NF,6,5,10,24,34
Congo (Brazzaville),Africa,NF,6,5,7,23,30
Kosovo,Europe,PF,4,4,23,29,52
Antigua and Barbuda,Americas,F,2,2,31,49,80
Netherlands,Europe,F,1,1,40,59,99
Fiji,Asia,PF,3,3,24,36,60
Libya,Africa,PF,4,5,21,20,41
Israel,Middle East,F,2,3,33,43,76
Liechtenstein,Europe,F,1,1,39,59,98
Bahrain,Middle East,NF,7,6,4,10,14
Vietnam,Asia,NF,7,5,2,17,19
Palau,Asia,F,1,1,37,55,92
Peru,Americas,F,2,3,30,41,71
South Korea,Asia,F,2,2,33,51,84
Liberia,Africa,PF,3,4,27,33,60
Netherlands,Europe,F,1,1,40,59,99
Uganda,Africa,NF,6,5,11,23,34
Morocco,Africa,PF,5,4,15,27,42
Romania,Europe,F,2,2,35,49,84
Togo,Africa,PF,5,4,15,28,43
Tibet,Asia,NF,7,7,-2,3,1
Lebanon,Middle East,PF,5,4,13,30,43
Belarus,Eurasia,NF,7,6,2,9,11
Samoa,Asia,F,2,2,32,49,81
Serbia,Europe,F,2,2,30,48,78
Honduras,Americas,PF,4,4,19,26,45
Sweden,Europe,F,1,1,40,59,99
Nauru,Asia,F,2,2,35,46,81
Andorra,Europe,F,1,1,39,57,96
Qatar,Middle East,NF,6,5,7,18,25
Sweden,Europe,F,1,1,40,60,100
West Bank,Middle East,NF,7,5,4,21,25
Italy,Europe,F,1,1,36,53,89
France,Europe,F,1,2,38,52,90
Montenegro,Europe,F,3,2,27,44,71
Pakistan,Asia,PF,4,5,19,24,43
Saudi Arabia,Middle East,NF,7,7,1,6,7
Oman,Middle East,NF,6,5,6,17,23
El Salvador,Americas,F,2,3,35,42,77
Chad,Africa,NF,7,6,5,16,21
United Kingdom,Europe,F,1,1,40,55,95
Australia,Asia,F,1,1,39,58,97
Tuvalu,Asia,F,1,1,37,57,94
Vietnam,Asia,NF,7,5,3,17,20
Syria,Middle East,NF,7,7,-1,6,5
South Korea,Asia,F,2,2,33,50,83
Uzbekistan,Eurasia,NF,7,7,0,4,4
Honduras,Americas,PF,4,5,19,25,44
Denmark,Europe,F,1,1,40,58,98
Bosnia and Herzegovina,Europe,PF,4,4,21,34,55
Zambia,Africa,PF,4,4,22,32,54
Switzerland,Europe,F,1,1,39,57,96
Argentina,Americas,F,2,2,33,49,82
Kosovo,Europe,PF,3,4,24,28,52
The Gambia,Africa,NF,6,6,7,14,21
Cyprus,Europe,F,1,1,38,56,94
Samoa,Asia,F,2,2,32,49,81
Hungary,Europe,F,3,2,29,47,76
Costa Rica,Americas,F,1,1,37,53,90
Lithuania,Europe,F,1,1,38,53,91
Costa Rica,Americas,F,1,1,38,53,91
Mexico,Americas,PF,3,3,27,36,63
Zambia,Africa,PF,3,4,26,34,60
Estonia,Europe,F,1,1,39,56,95
Transnistria,Eurasia,NF,6,6,9,13,22
St. Vincent and the Grenadines,Americas,F,1,1,37,54,91
Lithuania,Europe,F,1,1,37,53,90
Paraguay,Americas,PF,3,3,26,35,61
Uzbekistan,Eurasia,NF,7,7,0,4,4
Brazil,Americas,F,2,2,33,48,81
Guinea-Bissau,Africa,PF,5,4,17,29,46
Somaliland,Africa,PF,5,5,15,25,40
Germany,Europe,F,1,1,39,55,94
Malawi,Africa,PF,3,4,26,34,60
Qatar,Middle East,NF,6,5,7,18,25
Turkey,Europe,PF,3,4,26,29,55
Bulgaria,Europe,F,2,2,33,45,78
Niger,Africa,PF,4,4,20,28,48
Netherlands,Europe,F,1,1,40,59,99
Nauru,Asia,F,1,1,38,55,93
Zambia,Africa,PF,4,4,21,30,51
Zimbabwe,Africa,NF,5,6,12,16,28
Kazakhstan,Eurasia,NF,7,5,5,17,22
Nauru,Asia,F,1,1,38,54,92
Abkhazia,Eurasia,PF,4,5,18,22,40
China,Asia,NF,7,6,2,15,17
Estonia,Europe,F,1,1,38,56,94
Afghanistan,Asia,NF,5,6,13,14,27
Brazil,Americas,F,2,2,33,48,81
United States,Americas,F,1,1,37,56,93
Montenegro,Europe,F,3,2,27,45,72
Belgium,Europe,F,1,1,40,57,97
San Marino,Europe,F,1,1,38,55,93
Ireland,Europe,F,1,1,39,58,97
Seychelles,Africa,PF,3,3,28,43,71
Solomon Islands,Asia,F,3,2,27,44,71
Cuba,Americas,NF,7,6,1,11,12
Lithuania,Europe,F,1,1,38,53,91
Egypt,Africa,NF,6,5,9,18,27
Peru,Americas,F,2,3,31,42,73
Transnistria,Eurasia,NF,6,6,10,15,25
Mauritius,Africa,F,1,2,37,52,89
Monaco,Europe,F,3,1,27,57,84
Jamaica,Americas,F,2,3,34,41,75
Hong Kong,Asia,PF,5,2,15,44,59
El Salvador,Americas,F,2,3,34,36,70
Micronesia,Asia,F,1,1,37,55,92
Libya,Africa,NF,7,6,1,8,9
Bolivia,Americas,PF,3,3,29,39,68
Kiribati,Asia,F,1,1,37,56,93
Indian Kashmir,Asia,NF,6,5,7,20,27
Austria,Europe,F,1,1,38,58,96
Antigua and Barbuda,Americas,F,2,2,33,50,83
Equatorial Guinea,Africa,NF,7,7,1,7,8
Spain,Europe,F,1,1,37,53,90
Germany,Europe,F,1,1,39,56,95
Papua New Guinea,Asia,PF,3,3,24,36,60
Iraq,Middle East,NF,5,6,16,13,29
New Zealand,Asia,F,1,1,39,58,97
Cote d'Ivoire,Africa,PF,4,4,19,32,51
Philippines,Asia,PF,3,3,26,35,61
Mongolia,Asia,F,1,2,36,48,84
Antigua and Barbuda,Americas,F,2,2,33,52,85
Turkey,Europe,PF,3,4,24,29,53
Cambodia,Asia,NF,6,5,10,20,30
Panama,Americas,F,2,2,35,47,82
Somalia,Africa,NF,7,7,1,6,7
The Gambia,Africa,PF,4,5,20,21,41
Cameroon,Africa,NF,6,6,7,11,18
Grenada,Americas,F,1,2,37,52,89
Qatar,Middle East,NF,6,5,10,18,28
Hong Kong,Asia,PF,5,3,15,37,52
Eritrea,Africa,NF,7,7,1,2,3
Italy,Europe,F,1,1,36,54,90
Argentina,Americas,F,2,2,31,49,80
Netherlands,Europe,F,1,1,40,59,99
Brunei,Asia,NF,6,5,7,23,30
Eswatini,Africa,NF,7,5,1,20,21
Saudi Arabia,Middle East,NF,7,7,3,7,10
Kenya,Africa,PF,4,4,19,29,48
Solomon Islands,Asia,PF,3,3,25,43,68
Turkey,Europe,PF,3,4,28,32,60
Taiwan,Asia,F,1,2,37,52,89
North Korea,Asia,NF,7,7,0,3,3
Lebanon,Middle East,PF,5,4,16,32,48
Moldova,Eurasia,PF,3,3,26,35,61
Nagorno-Karabakh,Eurasia,PF,5,5,15,18,33
Bosnia and Herzegovina,Europe,PF,4,4,19,34,53
Kyrgyzstan,Eurasia,PF,5,5,14,24,38
Gaza Strip,Middle East,NF,7,6,3,9,12
Monaco,Europe,F,3,1,27,57,84
Pakistan,Asia,PF,5,5,15,22,37
Togo,Africa,PF,4,4,18,29,47
Sweden,Europe,F,1,1,40,60,100
France,Europe,F,1,2,38,52,90
Libya,Africa,NF,6,6,8,15,23
Honduras,Americas,PF,4,4,20,26,46
Israel,Middle East,F,2,3,34,42,76
Ecuador,Americas,PF,3,3,24,35,59
Tonga,Asia,F,3,2,29,44,73
Colombia,Americas,PF,3,3,29,37,66
Qatar,Middle East,NF,6,5,7,18,25
Benin,Africa,F,2,2,32,49,81
Israel,Middle East,F,1,2,36,45,81
Egypt,Africa,NF,6,6,6,12,18
Russia,Eurasia,NF,6,6,7,16,23
Bahrain,Middle East,NF,7,6,2,10,12
Czech Republic,Europe,F,1,1,36,55,91
Azerbaijan,Eurasia,NF,7,6,2,8,10
Mauritania,Africa,PF,5,5,14,21,35
Myanmar,Asia,NF,6,5,11,17,28
Germany,Europe,F,1,1,39,56,95
Crimea,Eurasia,NF,7,6,-1,10,9
St. Vincent and the Grenadines,Americas,F,1,1,36,55,91
Sudan,Africa,NF,7,7,2,5,7
South Sudan,Africa,NF,7,7,-2,4,2
Tibet,Asia,NF,7,7,-2,3,1
Zimbabwe,Africa,NF,5,6,12,16,28
Belize,Americas,F,2,1,34,53,87
Algeria,Africa,NF,6,5,10,24,34
Kenya,Africa,PF,4,4,22,31,53
Haiti,Americas,PF,5,5,15,22,37
Kosovo,Europe,PF,5,4,16,26,42
Armenia,Eurasia,PF,4,4,21,32,53
Seychelles,Africa,PF,3,3,25,42,67
Chile,Americas,F,1,1,37,57,94
Congo (Brazzaville),Africa,NF,7,5,2,19,21
Cameroon,Africa,NF,6,6,6,9,15
Ecuador,Americas,PF,3,3,24,36,60
Kiribati,Asia,F,1,1,37,56,93
Tanzania,Africa,PF,3,4,25,33,58
Andorra,Europe,F,1,1,38,55,93
Hungary,Europe,F,2,2,32,47,79
Ireland,Europe,F,1,1,39,57,96
Maldives,Asia,PF,4,4,19,29,48
Micronesia,Asia,F,1,1,37,55,92
Palau,Asia,F,1,1,37,55,92
Guinea-Bissau,Africa,PF,5,5,16,23,39
Guatemala,Americas,PF,4,4,22,31,53
Chad,Africa,NF,7,6,4,14,18
Albania,Europe,PF,3,3,27,40,67
Niger,Africa,PF,4,4,20,28,48
Zimbabwe,Africa,PF,5,5,12,17,29
Portugal,Europe,F,1,1,39,56,95
Cambodia,Asia,NF,6,5,11,21,32
Russia,Eurasia,NF,7,6,5,15,20
Iran,Middle East,NF,7,6,4,10,14
Chile,Americas,F,1,1,39,56,95
Denmark,Europe,F,1,1,40,57,97
Denmark,Europe,F,1,1,40,57,97
Saudi Arabia,Middle East,NF,7,7,1,6,7
Libya,Africa,PF,4,5,22,21,43
Greece,Europe,F,2,2,35,49,84
United Arab Emirates,Middle East,NF,6,6,8,14,22
Croatia,Europe,F,1,2,36,50,86
China,Asia,NF,7,6,1,15,16
Guyana,Americas,F,2,3,31,41,72
Belarus,Eurasia,NF,6,6,6,15,21
India,Asia,F,2,3,34,37,71
Bangladesh,Asia,PF,3,4,25,31,56
Syria,Middle East,NF,7,7,-3,4,1
Ireland,Europe,F,1,1,39,57,96
Andorra,Europe,F,1,1,39,57,96
Hong Kong,Asia,PF,5,2,15,44,59
Switzerland,Europe,F,1,1,39,57,96
Sri Lanka,Asia,PF,4,4,23,32,55
Transnistria,Eurasia,NF,6,6,10,14,24
France,Europe,F,1,1,38,57,95
Malaysia,Asia,PF,4,4,21,31,52
Norway,Europe,F,1,1,40,60,100
Israel,Middle East,F,1,2,36,45,81
Trinidad and Tobago,Americas,F,2,2,33,48,81
Mali,Africa,PF,5,4,17,27,44
Sudan,Africa,NF,7,6,2,15,17
Senegal,Africa,F,2,2,31,44,75
Lesotho,Africa,F,2,3,30,41,71
Tajikistan,Eurasia,NF,7,6,0,9,9
Italy,Europe,F,1,1,36,53,89
Central African Republic,Africa,NF,7,7,3,6,9
United Kingdom,Europe,F,1,1,40,54,94
St. Lucia,Americas,F,1,1,38,54,92
Syria,Middle East,NF,7,7,-2,3,1
Djibouti,Africa,NF,6,5,9,20,29
Libya,Africa,NF,7,6,1,8,9
Barbados,Americas,F,1,1,38,57,95
Slovakia,Europe,F,1,1,37,55,92
Norway,Europe,F,1,1,40,60,100
Latvia,Europe,F,1,2,37,52,89
Austria,Europe,F,1,1,37,56,93
Cambodia,Asia,NF,6,5,6,20,26
Singapore,Asia,PF,4,4,19,29,48
Poland,Europe,F,2,2,35,49,84
Myanmar,Asia,PF,5,5,14,18,32
Cambodia,Asia,NF,6,5,11,20,31
Uganda,Africa,NF,6,5,11,25,36
Tajikistan,Eurasia,NF,7,6,0,8,8
Sudan,Africa,NF,7,7,4,4,8
Uzbekistan,Eurasia,NF,7,6,2,8,10
Uganda,Africa,PF,5,4,12,28,40
Western Sahara,Africa,NF,7,7,-2,7,5
Guinea-Bissau,Africa,PF,5,5,16,24,40
The Gambia,Africa,PF,4,5,20,25,45
Uruguay,Americas,F,1,1,40,58,98
Lesotho,Africa,F,2,3,31,41,72
Romania,Europe,F,2,2,34,47,81
Marshall Islands,Asia,F,1,1,37,55,92
Israel,Middle East,F,2,3,33,43,76
Vanuatu,Asia,F,2,2,33,48,81
Costa Rica,Americas,F,1,1,38,53,91
Puerto Rico,Americas,F,1,1,37,53,90
Czech Republic,Europe,F,1,1,38,57,95
Georgia,Eurasia,PF,3,3,26,38,64
South Korea,Asia,F,2,2,33,50,83
South Sudan,Africa,NF,7,7,-2,4,2
United Arab Emirates,Middle East,NF,6,6,8,13,21
Luxembourg,Europe,F,1,1,38,59,97
Nauru,Asia,F,2,3,34,43,77
Abkhazia,Eurasia,PF,4,5,18,23,41
Singapore,Asia,PF,4,4,19,33,52
Denmark,Europe,F,1,1,40,57,97
Bulgaria,Europe,F,2,2,33,46,79
Panama,Americas,F,2,2,35,48,83
Philippines,Asia,PF,3,4,25,31,56
Ethiopia,Africa,NF,6,6,7,11,18
Ecuador,Americas,PF,3,3,25,38,63
The Gambia,Africa,NF,6,6,7,13,20
Malta,Europe,F,1,1,36,56,92
Italy,Europe,F,2,1,35,53,88
Zimbabwe,Africa,NF,6,5,11,17,28
Thailand,Asia,NF,6,5,8,25,33
Palau,Asia,F,1,1,37,55,92
Iran,Middle East,NF,6,6,7,10,17
The Gambia,Africa,NF,7,6,5,13,18
Hong Kong,Asia,PF,5,2,16,47,63
Bangladesh,Asia,PF,3,4,24,29,53
Algeria,Africa,NF,6,5,11,23,34
Papua New Guinea,Asia,PF,4,3,23,36,59
Haiti,Americas,PF,5,5,17,24,41
Indonesia,Asia,PF,2,4,30,32,62
Malaysia,Asia,PF,4,4,18,27,45
Malta,Europe,F,1,1,39,58,97
North Korea,Asia,NF,7,7,0,3,3
Sierra Leone,Africa,PF,3,3,28,38,66
South Africa,Africa,F,2,2,32,46,78
Austria,Europe,F,1,1,37,56,93
Puerto Rico,Americas,F,1,2,37,52,89
Malawi,Africa,PF,3,4,27,34,61
Guinea,Africa,PF,5,5,14,24,38
Tajikistan,Eurasia,NF,7,6,0,9,9
Nigeria,Africa,PF,3,5,25,25,50
Indian Kashmir,Asia,NF,6,5,7,20,27
Kiribati,Asia,F,1,1,38,55,93
Namibia,Africa,F,3,2,29,46,75
Western Sahara,Africa,NF,7,7,-3,7,4
Guatemala,Americas,PF,3,4,24,31,55
South Sudan,Africa,NF,7,7,-2,4,2
New Zealand,Asia,F,1,1,40,59,99
Czech Republic,Europe,F,1,1,38,57,95
Andorra,Europe,F,1,1,39,57,96
Mauritania,Africa,PF,5,5,14,21,35
Nicaragua,Americas,PF,5,4,14,33,47
Poland,Europe,F,1,2,36,49,85
Bhutan,Asia,PF,3,4,28,27,55
Namibia,Africa,F,2,2,30,46,76
South Ossetia,Eurasia,NF,7,6,-3,8,5
Nagorno-Karabakh,Eurasia,PF,5,5,12,18,30
Georgia,Eurasia,PF,3,3,25,38,63
St. Lucia,Americas,F,1,1,39,53,92
Angola,Africa,NF,6,5,10,21,31
Grenada,Americas,F,1,2,38,51,89
Uruguay,Americas,F,1,1,40,58,98
Liechtenstein,Europe,F,1,1,39,59,98
Seychelles,Africa,F,2,2,34,45,79
Estonia,Europe,F,1,1,38,56,94
New Zealand,Asia,F,1,1,40,58,98
North Macedonia,Europe,PF,3,3,26,38,64
Brunei,Asia,NF,6,5,6,22,28
Albania,Europe,PF,3,3,28,40,68
Andorra,Europe,F,1,1,39,55,94
Kyrgyzstan,Eurasia,PF,5,4,12,27,39
Guyana,Americas,F,2,3,30,41,71
Uganda,Africa,PF,6,4,11,26,37
Sweden,Europe,F,1,1,40,60,100
Uganda,Africa,NF,6,5,11,23,34
Jordan,Middle East,NF,6,5,11,24,35
Taiwan,Asia,F,1,1,37,56,93
Marshall Islands,Asia,F,1,1,37,55,92
Uruguay,Americas,F,1,1,40,58,98
Luxembourg,Europe,F,1,1,38,60,98
Kyrgyzstan,Eurasia,NF,7,5,4,23,27
Bhutan,Asia,PF,3,4,29,30,59
New Zealand,Asia,F,1,1,40,57,97
Senegal,Africa,PF,3,3,29,39,68
Zimbabwe,Africa,NF,6,5,11,17,28
Iraq,Middle East,NF,5,6,16,15,31
Estonia,Europe,F,1,1,39,56,95
Eritrea,Africa,NF,7,7,1,1,2
Italy,Europe,F,1,1,36,53,89
Micronesia,Asia,F,1,1,37,56,93
Comoros,Africa,PF,4,4,21,29,50
Hong Kong,Asia,PF,5,2,16,45,61
North Korea,Asia,NF,7,7,0,3,3
Bosnia and Herzegovina,Europe,PF,4,3,23,37,60
Burkina Faso,Africa,PF,4,4,23,33,56
North Korea,Asia,NF,7,7,0,3,3
Taiwan,Asia,F,1,1,38,56,94
Seychelles,Africa,PF,3,3,29,43,72
Nigeria,Africa,PF,4,4,20,26,46
Kazakhstan,Eurasia,NF,6,5,6,19,25
Tunisia,Africa,F,2,3,31,38,69
Jamaica,Americas,F,2,3,33,40,73
South Ossetia,Eurasia,NF,7,6,2,8,10
Israel,Middle East,F,1,2,36,44,80
Chad,Africa,NF,7,6,3,14,17
Rwanda,Africa,NF,6,6,9,16,25
Papua New Guinea,Asia,PF,4,3,23,39,62
Costa Rica,Americas,F,1,1,37,53,90
Afghanistan,Asia,NF,5,6,13,14,27
Spain,Europe,F,1,1,39,55,94
Uganda,Africa,NF,6,5,11,23,34
Qatar,Middle East,NF,6,5,10,18,28
Tunisia,Africa,F,2,3,32,39,71
Jamaica,Americas,F,2,2,34,46,80
Switzerland,Europe,F,1,1,39,57,96
Niger,Africa,PF,4,4,23,28,51
Bolivia,Americas,PF,3,3,29,39,68
Pakistan,Asia,PF,4,5,20,21,41
Trinidad and Tobago,Americas,F,2,2,33,48,81
Portugal,Europe,F,1,1,39,58,97
Kuwait,Middle East,PF,5,5,13,23,36
The Gambia,Africa,NF,6,6,8,12,20
Seychelles,Africa,PF,3,3,25,42,67
Zimbabwe,Africa,PF,5,5,12,20,32
Iceland,Europe,F,1,1,37,58,95
Micronesia,Asia,F,1,1,37,56,93
Slovenia,Europe,F,1,1,39,53,92
Somaliland,Africa,PF,4,5,18,24,42
Myanmar,Asia,NF,5,6,13,15,28
Vanuatu,Asia,F,2,2,32,48,80
Austria,Europe,F,1,1,38,58,96
Guinea,Africa,PF,5,5,17,24,41
Portugal,Europe,F,1,1,39,57,96
Nauru,Asia,F,1,2,37,51,88
Monaco,Europe,F,3,1,26,57,83
Switzerland,Europe,F,1,1,39,57,96
Bahamas,Americas,F,1,1,38,53,91
Eswatini,Africa,NF,7,6,1,15,16
Sri Lanka,Asia,PF,4,4,23,32,55
Dominica,Americas,F,1,1,37,56,93
Dominica,Americas,F,1,1,38,57,95
Nicaragua,Americas,PF,5,4,17,34,51
France,Europe,F,1,2,38,52,90
Denmark,Europe,F,1,1,40,57,97
Angola,Africa,NF,6,6,10,16,26
Pakistan,Asia,PF,5,5,15,22,37
Maldives,Asia,PF,4,5,19,21,40
Sudan,Africa,NF,7,7,2,4,6
Haiti,Americas,PF,5,5,17,24,41
Tanzania,Africa,PF,3,3,28,38,66
Pakistan,Asia,PF,5,5,16,22,38
Pakistani Kashmir,Asia,NF,6,5,9,20,29
Trinidad and Tobago,Americas,F,2,2,33,48,81
Malta,Europe,F,2,1,35,55,90
Bangladesh,Asia,PF,5,5,15,24,39
Kosovo,Europe,PF,3,4,24,30,54
Sri Lanka,Asia,PF,5,4,16,26,42
Mexico,Americas,PF,3,4,27,34,61
Lithuania,Europe,F,1,1,38,53,91
Syria,Middle East,NF,7,7,-3,2,-1
Ireland,Europe,F,1,1,39,58,97
Argentina,Americas,F,2,2,33,50,83
Turkmenistan,Eurasia,NF,7,7,0,2,2
San Marino,Europe,F,1,1,38,57,95
Malaysia,Asia,PF,4,4,18,27,45
Iran,Middle East,NF,6,6,7,10,17
Saudi Arabia,Middle East,NF,7,7,3,7,10
Saudi Arabia,Middle East,NF,7,7,3,7,10
Comoros,Africa,PF,3,4,25,30,55
Algeria,Africa,NF,6,5,10,22,32
South Korea,Asia,F,2,2,34,49,83
Czech Republic,Europe,F,1,1,36,55,91
Angola,Africa,NF,6,5,10,20,30
Bahrain,Middle East,NF,7,6,5,10,15
Nepal,Asia,PF,3,4,25,31,56
Belize,Americas,F,2,1,34,53,87
Barbados,Americas,F,1,1,40,58,98
Mozambique,Africa,PF,5,4,14,31,45
Canada,Americas,F,1,1,40,58,98
Ethiopia,Africa,NF,7,6,4,8,12
Sudan,Africa,NF,7,7,2,4,6
Brazil,Americas,F,2,2,33,48,81
Libya,Africa,NF,6,6,6,14,20
Algeria,Africa,NF,6,5,10,25,35
Gabon,Africa,NF,6,5,9,25,34
United Arab Emirates,Middle East,NF,6,6,7,13,20
Georgia,Eurasia,PF,4,3,23,37,60
Cameroon,Africa,NF,6,6,7,12,19
Cuba,Americas,NF,7,6,1,14,15
Lithuania,Europe,F,1,2,38,52,90
Finland,Europe,F,1,1,40,60,100
Samoa,Asia,F,2,2,32,49,81
Andorra,Europe,F,1,1,39,55,94
St. Vincent and the Grenadines,Americas,F,1,1,36,55,91
Tunisia,Africa,PF,3,4,26,33,59
Vanuatu,Asia,F,2,2,33,49,82
Mali,Africa,PF,5,4,17,27,44
Indian Kashmir,Asia,PF,4,4,22,28,50
Belgium,Europe,F,1,1,39,57,96
Sierra Leone,Africa,PF,3,3,28,38,66
Suriname,Americas,F,2,3,34,43,77
South Ossetia,Eurasia,NF,7,6,2,9,11
Georgia,Eurasia,PF,4,3,22,36,58
Brazil,Americas,F,2,3,31,42,73
Peru,Americas,F,2,3,30,42,72
Micronesia,Asia,F,1,1,37,55,92
Tanzania,Africa,PF,4,5,20,25,45
Slovakia,Europe,F,1,1,36,53,89
Ireland,Europe,F,1,1,39,58,97
Bahamas,Americas,F,1,1,38,58,96
Belarus,Eurasia,NF,7,6,4,13,17
Tajikistan,Eurasia,NF,6,6,8,16,24
Ethiopia,Africa,NF,6,6,7,11,18
Haiti,Americas,PF,4,5,19,24,43
St. Kitts and Nevis,Americas,F,1,1,38,53,91
Timor-Leste,Asia,PF,3,3,29,36,65
Samoa,Asia,F,2,2,30,51,81
El Salvador,Americas,F,2,3,35,42,77
Uganda,Africa,NF,6,5,11,24,35
Tonga,Asia,F,2,2,30,45,75
Turkey,Europe,NF,5,6,16,16,32
Venezuela,Americas,PF,5,5,13,22,35
Vanuatu,Asia,F,2,2,31,47,78
Georgia,Eurasia,PF,3,3,25,38,63
Chile,Americas,F,1,1,37,57,94
Sao Tome and Principe,Africa,F,2,2,35,49,84
Hong Kong,Asia,PF,6,4,10,33,43
Burkina Faso,Africa,PF,4,4,23,30,53
Indonesia,Asia,PF,2,4,30,34,64
Luxembourg,Europe,F,1,1,38,60,98
Kiribati,Asia,F,1,1,36,55,91
El Salvador,Americas,PF,3,4,26,33,59
Armenia,Eurasia,PF,4,4,20,31,51
Kenya,Africa,PF,4,4,19,29,48
Japan,Asia,F,1,1,40,56,96
Vietnam,Asia,NF,7,5,3,17,20
Argentina,Americas,F,2,2,35,49,84
St. Vincent and the Grenadines,Americas,F,1,1,36,55,91
Afghanistan,Asia,NF,6,6,10,14,24
Nauru,Asia,F,2,3,34,43,77
Czech Republic,Europe,F,1,1,36,55,91
Netherlands,Europe,F,1,1,40,59,99
Madagascar,Africa,PF,3,4,27,34,61
Pakistani Kashmir,Asia,NF,6,5,9,19,28
Cameroon,Africa,NF,6,6,9,15,24
Burundi,Africa,NF,7,6,4,10,14
Algeria,Africa,NF,6,5,10,22,32
Laos,Asia,NF,7,6,1,11,12
Albania,Europe,PF,3,3,24,39,63
Ireland,Europe,F,1,1,39,58,97
Somalia,Africa,NF,7,7,1,6,7
Denmark,Europe,F,1,1,40,57,97
Bahamas,Americas,F,1,1,38,54,92
Somalia,Africa,NF,7,7,0,5,5
Bosnia and Herzegovina,Europe,PF,3,3,24,37,61
Mozambique,Africa,PF,4,3,23,35,58
Liechtenstein,Europe,F,2,1,33,57,90
Bosnia and Herzegovina,Europe,PF,4,4,19,34,53
Bangladesh,Asia,PF,5,5,17,24,41
Senegal,Africa,F,2,2,33,45,78
Mauritania,Africa,PF,5,5,13,21,34
Serbia,Europe,F,2,2,31,49,80
Thailand,Asia,PF,6,4,6,26,32
Croatia,Europe,F,1,2,37,50,87
Bulgaria,Europe,F,2,2,33,47,80
Romania,Europe,F,2,2,34,49,83
Ethiopia,Africa,NF,5,6,12,11,23
Luxembourg,Europe,F,1,1,38,60,98
Kenya,Africa,PF,4,4,19,29,48
China,Asia,NF,7,6,-1,12,11
Grenada,Americas,F,1,2,37,52,89
Saudi Arabia,Middle East,NF,7,7,3,7,10
Romania,Europe,F,2,2,35,48,83
Qatar,Middle East,NF,6,5,9,18,27
Albania,Europe,PF,3,3,27,40,67
Armenia,Eurasia,PF,5,4,15,30,45
South Sudan,Africa,NF,6,5,11,20,31
Mali,Africa,NF,6,5,8,24,32
Cote d'Ivoire,Africa,PF,4,4,19,30,49
Namibia,Africa,F,2,2,31,46,77
Vietnam,Asia,NF,7,6,3,16,19
Eastern Donbas,Eurasia,NF,7,7,-1,5,4
Namibia,Africa,F,2,2,31,46,77
Ghana,Africa,F,2,2,35,45,80
Switzerland,Europe,F,1,1,39,57,96
Norway,Europe,F,1,1,40,60,100
Thailand,Asia,NF,7,5,5,24,29
Oman,Middle East,NF,6,5,6,18,24
Fiji,Asia,PF,3,3,24,35,59
South Korea,Asia,F,2,2,33,50,83
Nigeria,Africa,PF,4,5,20,23,43
India,Asia,PF,2,4,33,33,66
Congo (Kinshasa),Africa,NF,6,6,9,11,20
Transnistria,Eurasia,NF,6,6,10,14,24
Morocco,Africa,PF,5,5,13,24,37
Chile,Americas,F,1,1,39,56,95
Philippines,Asia,PF,3,3,27,35,62
Somaliland,Africa,PF,4,4,22,27,49
Comoros,Africa,PF,5,4,16,26,42
Bulgaria,Europe,F,2,2,34,46,80
Trinidad and Tobago,Americas,F,2,2,33,48,81
Benin,Africa,F,2,2,33,49,82
Denmark,Europe,F,1,1,40,58,98
Laos,Asia,NF,7,6,2,11,13
Suriname,Americas,F,2,3,34,43,77
Malaysia,Asia,PF,4,4,21,31,52
Laos,Asia,NF,7,6,1,11,12
Libya,Africa,NF,7,6,1,8,9
Bangladesh,Asia,PF,5,5,15,24,39
Guyana,Americas,F,2,3,30,43,73
Croatia,Europe,F,1,2,36,50,86
Chile,Americas,F,1,1,38,57,95
Thailand,Asia,NF,6,5,7,25,32
India,Asia,F,2,3,35,42,77
Somaliland,Africa,PF,4,5,21,25,46
Mauritius,Africa,F,1,2,38,52,90
Gabon,Africa,NF,6,5,9,25,34
North Korea,Asia,NF,7,7,0,3,3
Rwanda,Africa,NF,6,6,8,15,23
Switzerland,Europe,F,1,1,39,57,96
Brunei,Asia,NF,6,5,7,21,28
Saudi Arabia,Middle East,NF,7,7,3,7,10
Eritrea,Africa,NF,7,7,1,1,2
Hong Kong,Asia,PF,5,2,16,49,65
Moldova,Eurasia,PF,3,3,27,35,62
Denmark,Europe,F,1,1,40,58,98
Crimea,Eurasia,NF,7,6,-2,10,8
Congo (Brazzaville),Africa,NF,7,5,2,18,20
Lebanon,Middle East,PF,5,4,14,30,44
Western Sahara,Africa,NF,7,7,-2,7,5
Kosovo,Europe,PF,3,4,25,31,56
Central African Republic,Africa,NF,7,7,3,4,7
Guinea-Bissau,Africa,NF,6,5,7,23,30
Monaco,Europe,F,2,1,31,57,88
Burundi,Africa,NF,7,6,3,10,13
Italy,Europe,F,1,1,36,53,89
Madagascar,Africa,PF,3,4,24,32,56
Slovakia,Europe,F,1,1,37,54,91
Abkhazia,Eurasia,PF,5,5,17,23,40
Bangladesh,Asia,PF,4,4,21,29,50
Egypt,Africa,NF,6,5,9,17,26
Fiji,Asia,PF,3,4,25,34,59
Timor-Leste,Asia,PF,3,4,29,34,63
Indonesia,Asia,PF,2,4,30,29,59
Nicaragua,Americas,PF,4,3,19,35,54
Cyprus,Europe,F,1,1,38,56,94
Laos,Asia,NF,7,6,1,11,12
Zambia,Africa,PF,4,4,22,33,55
Panama,Americas,F,1,2,36,48,84
Ecuador,Americas,PF,3,3,24,35,59
Mozambique,Africa,PF,4,4,22,34,56
Bhutan,Asia,PF,3,4,28,27,55
Puerto Rico,Americas,F,1,2,37,52,89
Tuvalu,Asia,F,1,1,37,56,93
Tanzania,Africa,PF,3,3,29,35,64
Eritrea,Africa,NF,7,7,1,2,3
Tibet,Asia,NF,7,7,-2,3,1
Lithuania,Europe,F,1,2,38,51,89
Eswatini,Africa,NF,7,6,1,15,16
Tunisia,Africa,F,1,3,37,42,79
United Arab Emirates,Middle East,NF,7,6,5,12,17
Turkmenistan,Eurasia,NF,7,7,0,4,4
Finland,Europe,F,1,1,40,60,100
Bahrain,Middle East,NF,7,6,2,10,12
Uruguay,Americas,F,1,1,40,58,98
Angola,Africa,NF,6,6,10,14,24
Bahrain,Middle East,NF,7,6,2,10,12
Philippines,Asia,PF,3,4,25,30,55
Congo (Kinshasa),Africa,NF,7,6,4,15,19
Solomon Islands,Asia,F,2,2,30,49,79
Georgia,Eurasia,PF,3,3,26,38,64
Kuwait,Middle East,PF,5,5,13,23,36
Iraq,Middle East,NF,6,6,11,13,24
Paraguay,Americas,PF,3,3,27,38,65
Belgium,Europe,F,1,1,40,56,96
Armenia,Eurasia,PF,5,4,16,30,46
Cote d'Ivoire,Africa,PF,5,4,17,28,45
Marshall Islands,Asia,F,1,1,37,55,92
Australia,Asia,F,1,1,39,56,95
Cabo Verde,Africa,F,1,1,38,54,92
Iceland,Europe,F,1,1,37,57,94
Cuba,Americas,NF,7,6,1,12,13
Crimea,Eurasia,NF,7,6,-1,10,9
Syria,Middle East,NF,7,7,-3,4,1
Senegal,Africa,F,2,2,33,45,78
Grenada,Americas,F,1,2,37,51,88
Israel,Middle East,F,1,3,36,43,79
Serbia,Europe,F,2,2,30,48,78
Mexico,Americas,PF,3,3,28,37,65
Congo (Kinshasa),Africa,NF,7,6,4,14,18
Nepal,Asia,PF,4,4,20,27,47
United States,Americas,F,1,1,37,55,92
Morocco,Africa,PF,5,4,15,26,41
Montenegro,Europe,PF,3,3,25,42,67
Indian Kashmir,Asia,NF,6,5,8,20,28
Mali,Africa,PF,4,4,18,26,44
Mali,Africa,NF,7,5,5,19,24
Cabo Verde,Africa,F,1,1,37,53,90
Libya,Africa,NF,7,6,1,8,9
Mongolia,Asia,F,1,2,36,48,84
Sao Tome and Principe,Africa,F,2,2,34,47,81
Ghana,Africa,F,1,2,36,47,83
Chad,Africa,NF,7,6,5,16,21
Belarus,Eurasia,NF,7,6,4,10,14
Latvia,Europe,F,1,2,36,51,87
Turkmenistan,Eurasia,NF,7,7,0,4,4
Slovenia,Europe,F,1,1,39,56,95
Colombia,Americas,PF,3,3,29,37,66
St. Vincent and the Grenadines,Americas,F,1,1,36,54,90
Portugal,Europe,F,1,1,39,57,96
New Zealand,Asia,F,1,1,40,58,98
Sao Tome and Principe,Africa,F,2,2,34,49,83
Madagascar,Africa,PF,3,4,24,32,56
United Arab Emirates,Middle East,NF,7,6,5,12,17
Nigeria,Africa,PF,3,5,25,25,50
St. Lucia,Americas,F,1,1,39,53,92
Northern Cyprus,Europe,F,2,2,32,47,79
Belarus,Eurasia,NF,7,6,4,10,14
St. Kitts and Nevis,Americas,F,1,1,37,53,90
Guinea,Africa,PF,5,5,17,23,40
United Arab Emirates,Middle East,NF,6,6,7,13,20
Pakistani Kashmir,Asia,NF,6,5,9,20,29
Japan,Asia,F,1,1,37,53,90
West Bank,Middle East,NF,7,5,5,23,28
Portugal,Europe,F,1,1,39,58,97
South Sudan,Africa,NF,6,6,8,16,24
Transnistria,Eurasia,NF,6,6,10,14,24
Cyprus,Europe,F,1,1,38,56,94
Iceland,Europe,F,1,1,37,57,94
Namibia,Africa,F,2,2,30,47,77
Tibet,Asia,NF,7,7,-2,3,1
Nepal,Asia,PF,3,4,25,26,51
Costa Rica,Americas,F,1,1,38,53,91
Taiwan,Asia,F,1,2,37,51,88
Eritrea,Africa,NF,7,7,1,2,3
North Korea,Asia,NF,7,7,0,3,3
Kiribati,Asia,F,1,1,37,55,92
Kuwait,Middle East,PF,5,5,13,23,36
Oman,Middle East,NF,6,5,9,17,26
Tuvalu,Asia,F,1,1,37,56,93
South Korea,Asia,F,2,2,32,50,82
Iraq,Middle East,NF,5,6,17,14,31
Brunei,Asia,NF,6,5,7,23,30
Oman,Middle East,NF,6,5,6,17,23
Suriname,Americas,F,2,2,34,45,79
Timor-Leste,Asia,F,2,3,32,37,69
Equatorial Guinea,Africa,NF,7,7,1,6,7
United States,Americas,F,2,1,33,53,86
Sao Tome and Principe,Africa,F,2,2,34,47,81
El Salvador,Americas,PF,2,4,32,34,66
Monaco,Europe,F,2,1,31,57,88
Kiribati,Asia,F,1,1,36,55,91
Comoros,Africa,PF,3,4,25,30,55
Bosnia and Herzegovina,Europe,PF,4,4,19,34,53
St. Kitts and Nevis,Americas,F,2,1,35,54,89
Libya,Africa,NF,7,6,3,10,13
Comoros,Africa,PF,5,4,16,26,42
Iraq,Middle East,NF,5,6,17,15,32
Jordan,Middle East,NF,6,5,11,22,33
South Africa,Africa,F,2,2,33,46,79
Seychelles,Africa,PF,3,3,28,43,71
China,Asia,NF,7,6,0,14,14
United Kingdom,Europe,F,1,1,40,55,95
Rwanda,Africa,NF,6,6,8,16,24
Cuba,Americas,NF,7,6,1,14,15
Malaysia,Asia,PF,4,4,18,26,44
Ghana,Africa,F,1,2,37,46,83
Afghanistan,Asia,NF,6,6,11,13,24
Kosovo,Europe,PF,3,4,24,28,52
Jordan,Middle East,PF,5,5,12,25,37
Iceland,Europe,F,1,1,37,57,94
Vietnam,Asia,NF,7,5,3,17,20
Dominica,Americas,F,1,1,38,57,95
Netherlands,Europe,F,1,1,40,58,98
Panama,Americas,F,2,2,35,48,83
Burundi,Africa,NF,7,6,4,10,14
Spain,Europe,F,1,1,38,56,94
Spain,Europe,F,1,1,39,56,95
Hungary,Europe,F,1,2,36,52,88
Malawi,Africa,PF,3,3,26,37,63
South Sudan,Africa,NF,7,7,-3,4,1
Mauritania,Africa,NF,6,5,11,23,34
Russia,Eurasia,NF,7,6,5,15,20
Western Sahara,Africa,NF,7,7,-3,7,4
Congo (Kinshasa),Africa,NF,6,6,9,16,25
Guyana,Americas,F,2,3,32,42,74
Guatemala,Americas,PF,4,4,21,31,52
Mexico,Americas,PF,3,3,26,36,62
Djibouti,Africa,NF,6,5,7,19,26
Tuvalu,Asia,F,1,1,37,57,94
South Korea,Asia,F,2,2,33,50,83
Morocco,Africa,PF,5,5,14,25,39
Burkina Faso,Africa,PF,4,3,23,37,60
Brazil,Americas,F,2,3,31,43,74
Liechtenstein,Europe,F,2,1,33,57,90
Venezuela,Americas,PF,5,5,15,24,39
Hungary,Europe,F,1,2,36,52,88
Maldives,Asia,PF,5,5,17,23,40
Moldova,Eurasia,PF,3,3,28,35,63
Grenada,Americas,F,1,2,38,51,89
Guatemala,Americas,PF,3,4,24,32,56
Kyrgyzstan,Eurasia,PF,5,5,12,25,37
Slovenia,Europe,F,1,1,39,53,92
Belgium,Europe,F,1,1,40,55,95
Malaysia,Asia,PF,4,4,20,30,50
Tunisia,Africa,F,1,3,36,43,79
Qatar,Middle East,NF,6,5,7,18,25
Montenegro,Europe,PF,3,3,26,43,69
Nepal,Asia,PF,3,4,24,28,52
Dominican Republic,Americas,PF,3,3,26,41,67
Maldives,Asia,PF,5,5,14,21,35
Abkhazia,Eurasia,PF,4,5,18,23,41
United States,Americas,F,1,1,36,54,90
Austria,Europe,F,1,1,38,58,96
Kenya,Africa,PF,4,4,22,29,51
Cuba,Americas,NF,7,6,1,13,14
Myanmar,Asia,NF,6,5,9,17,26
St. Lucia,Americas,F,1,1,39,54,93
Azerbaijan,Eurasia,NF,7,6,3,9,12
Russia,Eurasia,NF,6,6,7,15,22
Luxembourg,Europe,F,1,1,38,60,98
Jamaica,Americas,F,2,2,34,44,78
Chad,Africa,NF,7,6,3,14,17
Egypt,Africa,NF,6,6,6,12,18
Haiti,Americas,NF,6,5,11,22,33
Malawi,Africa,PF,3,4,26,34,60
Brazil,Americas,F,2,2,31,44,75
Tibet,Asia,NF,7,7,-2,3,1
Suriname,Americas,F,2,2,34,45,79
Vietnam,Asia,NF,7,5,3,17,20
Tunisia,Africa,PF,3,3,27,36,63
Crimea,Eurasia,NF,7,6,-1,11,10
Sierra Leone,Africa,PF,3,3,28,37,65
Bhutan,Asia,PF,3,4,29,27,56
Sudan,Africa,NF,7,6,2,10,12
Fiji,Asia,PF,4,3,23,35,58
Congo (Brazzaville),Africa,NF,6,5,6,22,28
Central African Republic,Africa,NF,7,7,4,5,9
Pakistan,Asia,PF,4,5,20,22,42
Palau,Asia,F,1,1,37,55,92
Ghana,Africa,F,2,2,35,47,82
Norway,Europe,F,1,1,40,60,100
China,Asia,NF,7,6,-2,11,9
Serbia,Europe,F,2,2,30,48,78
Canada,Americas,F,1,1,40,59,99
France,Europe,F,1,1,38,57,95
Jordan,Middle East,NF,6,5,11,25,36
Pakistani Kashmir,Asia,NF,6,5,9,19,28
Azerbaijan,Eurasia,NF,6,6,6,16,22
Maldives,Asia,PF,5,5,14,21,35
Tunisia,Africa,PF,3,3,26,38,64
Indian Kashmir,Asia,PF,4,4,22,27,49
China,Asia,NF,7,6,-1,11,10
Singapore,Asia,PF,4,4,19,32,51
Cuba,Americas,NF,7,6,1,13,14
Niger,Africa,PF,4,4,20,29,49
Gabon,Africa,NF,6,5,9,25,34
Croatia,Europe,F,1,2,36,50,86
Lebanon,Middle East,PF,5,4,14,31,45
Belgium,Europe,F,1,1,40,57,97
Paraguay,Americas,PF,3,3,27,37,64
Vanuatu,Asia,F,2,2,33,49,82
Dominica,Americas,F,1,1,38,57,95
Ukraine,Eurasia,PF,3,4,26,34,60
Philippines,Asia,PF,3,3,26,37,63
Ukraine,Eurasia,PF,3,3,27,35,62
Mauritius,Africa,F,1,2,36,50,86
Yemen,Middle East,NF,7,6,1,10,11
South Korea,Asia,F,1,2,36,50,86
Niger,Africa,PF,4,4,20,29,49
The Gambia,Africa,PF,4,4,20,26,46
Sri Lanka,Asia,PF,5,4,16,27,43
Japan,Asia,F,1,1,40,56,96
Australia,Asia,F,1,1,40,58,98
South Ossetia,Eurasia,NF,7,6,1,9,10
Spain,Europe,F,1,1,39,57,96
Nagorno-Karabakh,Eurasia,PF,5,5,12,19,31
Hungary,Europe,PF,3,3,27,43,70
Benin,Africa,F,2,2,33,49,82
Greece,Europe,F,2,2,35,48,83
Azerbaijan,Eurasia,NF,7,7,2,7,9
Timor-Leste,Asia,F,2,3,33,39,72
Guyana,Americas,F,2,3,30,43,73
Belize,Americas,F,1,2,36,51,87
Peru,Americas,F,2,3,31,41,72
Thailand,Asia,NF,6,5,7,25,32
Uzbekistan,Eurasia,NF,7,7,0,4,4
Turkmenistan,Eurasia,NF,7,7,0,4,4
Fiji,Asia,PF,3,3,24,37,61
Latvia,Europe,F,2,2,33,51,84
Oman,Middle East,NF,6,5,9,17,26
Ethiopia,Africa,NF,6,6,7,12,19
Bahamas,Americas,F,1,1,38,53,91
Cameroon,Africa,NF,6,6,9,16,25
Sierra Leone,Africa,PF,3,3,28,37,65
Eritrea,Africa,NF,7,7,1,2,3
Barbados,Americas,F,1,1,40,59,99
Czech Republic,Europe,F,1,1,36,55,91
Namibia,Africa,F,2,2,31,46,77
Papua New Guinea,Asia,PF,4,3,23,36,59
Uzbekistan,Eurasia,NF,7,7,1,6,7
Kuwait,Middle East,PF,5,5,13,23,36
Kenya,Africa,PF,4,4,22,29,51
Sweden,Europe,F,1,1,40,60,100
Pakistani Kashmir,Asia,NF,6,5,9,19,28
Venezuela,Americas,PF,5,5,14,24,38
Nigeria,Africa,PF,3,5,25,25,50
United States,Americas,F,1,1,36,53,89
Senegal,Africa,F,2,2,32,46,78
Mexico,Americas,PF,3,3,28,36,64
Honduras,Americas,PF,4,4,19,27,46
Liberia,Africa,PF,3,4,27,33,60
Bosnia and Herzegovina,Europe,PF,4,4,19,34,53
Poland,Europe,F,2,2,34,48,82
Bhutan,Asia,PF,3,4,29,27,56
Equatorial Guinea,Africa,NF,7,7,1,7,8
Northern Cyprus,Europe,F,2,2,32,47,79
Nicaragua,Americas,NF,6,5,10,20,30
Azerbaijan,Eurasia,NF,7,6,2,8,10
Ecuador,Americas,PF,3,3,27,38,65
Argentina,Americas,F,2,2,35,49,84
Guinea-Bissau,Africa,PF,5,5,16,25,41
Taiwan,Asia,F,1,1,37,54,91
China,Asia,NF,7,6,2,15,17
St. Lucia,Americas,F,1,1,38,53,91
Mongolia,Asia,F,1,2,36,49,85
Kiribati,Asia,F,1,1,37,56,93
Spain,Europe,F,1,1,38,56,94
Bosnia and Herzegovina,Europe,PF,4,4,21,34,55
Croatia,Europe,F,1,2,37,50,87
Brunei,Asia,NF,6,5,7,23,30
Dominican Republic,Americas,PF,3,3,29,41,70
Germany,Europe,F,1,1,39,55,94
Cyprus,Europe,F,1,1,38,55,93
Seychelles,Africa,PF,3,3,28,43,71
Uzbekistan,Eurasia,NF,7,7,0,3,3
San Marino,Europe,F,1,1,38,55,93
Dominican Republic,Americas,PF,3,3,27,41,68
St. Kitts and Nevis,Americas,F,1,1,37,53,90
Zimbabwe,Africa,NF,6,6,11,14,25
Singapore,Asia,PF,4,4,19,32,51
Singapore,Asia,PF,4,4,19,31,50
Algeria,Africa,NF,6,5,11,23,34
Guyana,Americas,F,2,3,32,43,75
Somaliland,Africa,PF,5,5,15,25,40
Comoros,Africa,PF,3,4,24,31,55
Micronesia,Asia,F,1,1,37,56,93
Algeria,Africa,NF,6,5,11,24,35
Germany,Europe,F,1,1,39,55,94
Pakistani Kashmir,Asia,NF,6,5,9,19,28
Kosovo,Europe,PF,3,4,24,28,52
Guinea,Africa,PF,5,5,17,24,41
St. Kitts and Nevis,Americas,F,1,1,36,53,89
Kenya,Africa,PF,4,4,19,29,48
Algeria,Africa,NF,6,5,10,24,34
Nepal,Asia,PF,3,4,24,27,51
Congo (Brazzaville),Africa,NF,6,5,7,22,29
Taiwan,Asia,F,1,2,36,52,88
Liechtenstein,Europe,F,2,1,33,58,91
Slovakia,Europe,F,1,2,36,52,88
Micronesia,Asia,F,1,1,37,55,92
Cambodia,Asia,NF,6,5,11,20,31
Malta,Europe,F,2,1,35,56,91
Cuba,Americas,NF,7,6,1,10,11
Central African Republic,Africa,NF,7,7,4,6,10
Uzbekistan,Eurasia,NF,7,6,1,8,9
Mongolia,Asia,F,1,2,36,48,84
Bulgaria,Europe,F,2,2,33,47,80
South Africa,Africa,F,2,2,34,47,81
Angola,Africa,NF,6,5,11,20,31
Sierra Leone,Africa,PF,3,3,28,37,65
Estonia,Europe,F,1,1,38,56,94
Brunei,Asia,NF,6,5,7,22,29
Laos,Asia,NF,7,6,1,11,12
Turkmenistan,Eurasia,NF,7,7,0,2,2
Burkina Faso,Africa,PF,4,3,23,37,60
Cyprus,Europe,F,1,1,38,55,93
Moldova,Eurasia,PF,3,3,25,35,60
Slovenia,Europe,F,1,1,38,53,91
San Marino,Europe,F,1,1,38,59,97
Colombia,Americas,PF,3,3,29,36,65
Peru,Americas,F,2,3,31,42,73
St. Kitts and Nevis,Americas,F,1,1,36,53,89
Iceland,Europe,F,1,1,38,59,97
Andorra,Europe,F,1,1,38,55,93
Somaliland,Africa,PF,4,5,19,25,44
Qatar,Middle East,NF,6,5,10,18,28
Switzerland,Europe,F,1,1,39,57,96
Ecuador,Americas,PF,3,3,27,40,67
Australia,Asia,F,1,1,39,58,97
Japan,Asia,F,1,2,37,51,88
Botswana,Africa,F,3,2,28,44,72
Somalia,Africa,NF,7,7,1,6,7
Cabo Verde,Africa,F,1,1,37,53,90
Zambia,Africa,PF,4,4,22,32,54
Cote d'Ivoire,Africa,PF,5,5,13,21,34
Kosovo,Europe,PF,4,4,23,31,54
Maldives,Asia,PF,4,5,19,24,43
Yemen,Middle East,NF,6,6,9,16,25
Liechtenstein,Europe,F,2,1,33,57,90
Romania,Europe,F,2,2,35,48,83
Liberia,Africa,PF,3,4,28,34,62
South Africa,Africa,F,2,2,33,45,78
Sao Tome and Principe,Africa,F,2,2,35,49,84
Dominica,Americas,F,1,1,37,56,93
Vanuatu,Asia,F,2,2,32,47,79
Laos,Asia,NF,7,6,2,12,14
Vietnam,Asia,NF,7,5,3,17,20
Morocco,Africa,PF,5,4,15,26,41
Ghana,Africa,F,1,2,37,46,83
Mongolia,Asia,F,1,2,36,49,85
Dominica,Americas,F,1,1,37,56,93
North Korea,Asia,NF,7,7,0,3,3
Botswana,Africa,F,3,2,28,44,72
Transnistria,Eurasia,NF,6,6,8,12,20
Kazakhstan,Eurasia,NF,7,5,5,18,23
Mali,Africa,NF,6,5,9,24,33
Benin,Africa,PF,5,3,17,42,59
El Salvador,Americas,F,2,3,32,35,67
Chile,Americas,F,1,1,38,56,94
Gabon,Africa,NF,7,5,4,19,23
Cabo Verde,Africa,F,1,1,37,53,90
United Kingdom,Europe,F,1,1,39,54,93
Dominican Republic,Americas,F,2,2,31,44,75
United Arab Emirates,Middle East,NF,7,6,5,12,17
Indonesia,Asia,PF,2,4,30,34,64
Moldova,Eurasia,PF,3,4,26,34,60
New Zealand,Asia,F,1,1,40,58,98
Somaliland,Africa,PF,4,5,21,25,46
Bangladesh,Asia,PF,4,4,20,27,47
Samoa,Asia,F,2,2,30,50,80
Chile,Americas,F,1,1,38,55,93
Sierra Leone,Africa,PF,3,3,28,37,65
India,Asia,F,2,3,35,42,77
Saudi Arabia,Middle East,NF,7,7,1,6,7
United Kingdom,Europe,F,1,1,40,57,97
Greece,Europe,F,1,2,37,51,88
Sao Tome and Principe,Africa,F,2,2,35,49,84
Uganda,Africa,NF,6,5,11,25,36
Myanmar,Asia,PF,5,5,13,18,31
Bangladesh,Asia,PF,4,4,19,26,45
El Salvador,Americas,F,2,3,33,36,69
West Bank,Middle East,NF,7,5,4,21,25
Equatorial Guinea,Africa,NF,7,7,0,6,6
Equatorial Guinea,Africa,NF,7,7,1,7,8
Romania,Europe,F,2,2,35,48,83
Philippines,Asia,PF,3,4,25,34,59
Belgium,Europe,F,1,1,39,57,96
Nepal,Asia,PF,3,4,25,32,57
Jordan,Middle East,NF,6,5,11,25,36
Bosnia and Herzegovina,Europe,PF,4,3,22,35,57
Tuvalu,Asia,F,1,1,37,57,94
Japan,Asia,F,1,1,40,56,96
Papua New Guinea,Asia,PF,3,3,25,38,63
Cote d'Ivoire,Africa,PF,5,4,16,28,44
Trinidad and Tobago,Americas,F,2,2,33,49,82
Kenya,Africa,PF,4,4,22,29,51
Sao Tome and Principe,Africa,F,2,2,34,48,82
Grenada,Americas,F,1,2,37,52,89
Madagascar,Africa,PF,5,4,15,28,43
Timor-Leste,Asia,F,2,3,32,39,71
Taiwan,Asia,F,1,1,38,56,94
Kazakhstan,Eurasia,NF,7,5,5,18,23
Honduras,Americas,PF,4,4,19,26,45
Romania,Europe,F,2,2,35,49,84
Solomon Islands,Asia,PF,4,3,22,43,65
Malta,Europe,F,1,1,39,58,97
Ireland,Europe,F,1,1,39,58,97
Laos,Asia,NF,7,6,2,12,14
Palau,Asia,F,1,1,37,55,92
Bolivia,Americas,PF,3,3,29,39,68
Equatorial Guinea,Africa,NF,7,7,0,6,6
Serbia,Europe,PF,4,3,21,41,62
Ukraine,Eurasia,PF,3,3,25,36,61
Qatar,Middle East,NF,6,5,9,17,26
Belarus,Eurasia,NF,7,7,2,6,8
Greece,Europe,F,2,2,35,48,83
Brazil,Americas,F,2,2,31,48,79
Ukraine,Eurasia,PF,4,3,21,36,57
Nauru,Asia,F,2,3,34,43,77
Guinea-Bissau,Africa,PF,5,5,17,23,40
Burundi,Africa,NF,7,6,3,11,14
Greece,Europe,F,2,2,35,48,83
Tajikistan,Eurasia,NF,7,6,1,10,11
Nagorno-Karabakh,Eurasia,PF,5,5,12,19,31
Colombia,Americas,PF,3,4,29,34,63
Morocco,Africa,PF,5,5,14,25,39
Peru,Americas,F,2,3,30,41,71
Guinea-Bissau,Africa,PF,5,4,17,27,44
Somaliland,Africa,PF,4,5,21,25,46
South Ossetia,Eurasia,NF,7,6,2,8,10
Grenada,Americas,F,1,2,38,51,89
Barbados,Americas,F,1,1,38,57,95
Bulgaria,Europe,F,2,2,33,46,79
Bolivia,Americas,PF,3,3,29,40,69
Belgium,Europe,F,1,1,39,57,96
The Gambia,Africa,NF,6,6,7,16,23
Nigeria,Africa,PF,4,5,23,25,48
Benin,Africa,PF,4,2,21,44,65
Colombia,Americas,PF,3,3,29,35,64
Belarus,Eurasia,NF,7,6,4,10,14
Montenegro,Europe,PF,4,3,23,42,65
Yemen,Middle East,NF,7,6,1,12,13
Papua New Guinea,Asia,PF,4,3,23,36,59
Djibouti,Africa,NF,7,5,5,19,24
Canada,Americas,F,1,1,40,58,98
Turkmenistan,Eurasia,NF,7,7,1,6,7
Estonia,Europe,F,1,1,38,56,94
Liechtenstein,Europe,F,1,1,39,59,98
Australia,Asia,F,1,1,40,58,98
Argentina,Americas,F,2,2,31,49,80
Sri Lanka,Asia,PF,3,4,24,32,56
Malta,Europe,F,1,1,39,57,96
Seychelles,Africa,PF,3,3,26,42,68
Fiji,Asia,PF,3,4,26,34,60
Lithuania,Europe,F,1,1,37,53,90
Crimea,Eurasia,NF,7,6,-1,10,9
India,Asia,F,2,3,34,42,76
Sri Lanka,Asia,PF,3,4,24,32,56
Oman,Middle East,NF,6,5,9,17,26
Singapore,Asia,PF,4,4,19,28,47
Burkina Faso,Africa,PF,5,3,17,36,53
Monaco,Europe,F,3,1,25,57,82
Ghana,Africa,F,1,2,37,47,84
Pakistani Kashmir,Asia,NF,6,5,9,19,28
Turkey,Europe,NF,5,6,15,16,31
Egypt,Africa,NF,6,5,9,22,31
North Macedonia,Europe,PF,3,3,26,38,64
Comoros,Africa,PF,3,4,24,31,55
Haiti,Americas,PF,5,5,17,24,41
Samoa,Asia,F,2,2,32,51,83
Kyrgyzstan,Eurasia,PF,5,5,14,25,39
Burkina Faso,Africa,PF,5,3,17,36,53
Japan,Asia,F,1,1,40,56,96
Jamaica,Americas,F,2,3,34,41,75
Venezuela,Americas,NF,6,5,11,19,30
Mauritius,Africa,F,1,2,38,52,90
Liechtenstein,Europe,F,2,1,33,57,90
Tonga,Asia,F,2,2,31,44,75
Timor-Leste,Asia,PF,3,3,29,36,65
Tuvalu,Asia,F,1,1,37,57,94
South Africa,Africa,F,2,2,33,46,79
Benin,Africa,F,2,2,32,50,82
Benin,Africa,F,2,2,32,48,80
Kyrgyzstan,Eurasia,PF,5,5,13,24,37
Ecuador,Americas,F,2,3,31,40,71
Rwanda,Africa,NF,6,6,8,14,22
Turkmenistan,Eurasia,NF,7,7,0,2,2
Malawi,Africa,PF,3,3,26,37,63
Yemen,Middle East,NF,7,6,1,8,9
Sudan,Africa,NF,7,7,2,5,7
Angola,Africa,NF,6,5,11,18,29
Haiti,Americas,PF,5,5,15,24,39
Zambia,Africa,PF,3,4,25,34,59
Armenia,Eurasia,PF,4,4,23,32,55
Suriname,Americas,F,2,2,34,44,78
Dominica,Americas,F,1,1,38,57,95
Bahamas,Americas,F,1,1,38,53,91
Canada,Americas,F,1,1,40,58,98
Zambia,Africa,PF,3,4,26,34,60
Crimea,Eurasia,NF,7,6,-2,9,7
Guatemala,Americas,PF,4,4,23,31,54
Estonia,Europe,F,1,1,38,56,94
Transnistria,Eurasia,NF,6,6,10,14,24
Costa Rica,Americas,F,1,1,38,53,91
New Zealand,Asia,F,1,1,39,58,97
Russia,Eurasia,NF,6,5,7,20,27
Venezuela,Americas,NF,7,6,2,14,16
Northern Cyprus,Europe,F,3,2,28,50,78
Senegal,Africa,F,2,2,33,46,79
Marshall Islands,Asia,F,1,1,36,55,91
Eastern Donbas,Eurasia,NF,7,7,-1,5,4
South Korea,Asia,F,2,2,34,50,84
Gaza Strip,Middle East,NF,7,6,3,9,12
Tajikistan,Eurasia,NF,7,6,2,14,16
Russia,Eurasia,NF,7,6,5,14,19
Eastern Donbas,Eurasia,NF,7,7,-1,6,5
Nepal,Asia,PF,4,4,23,27,50
Austria,Europe,F,1,1,37,56,93
Canada,Americas,F,1,1,40,59,99
Philippines,Asia,PF,3,3,26,37,63
Nicaragua,Americas,NF,6,5,10,21,31
Cambodia,Asia,NF,6,5,9,20,29
Jordan,Middle East,PF,5,5,12,25,37
Ghana,Africa,F,2,2,35,47,82
Eswatini,Africa,NF,7,5,1,19,20
Ghana,Africa,F,1,2,37,47,84
Nagorno-Karabakh,Eurasia,PF,5,5,15,18,33
Poland,Europe,F,2,2,34,47,81
Seychelles,Africa,PF,3,3,25,42,67
Mauritania,Africa,NF,6,5,9,21,30
Turkey,Europe,NF,5,6,16,16,32
Micronesia,Asia,F,1,1,37,56,93
Pakistani Kashmir,Asia,NF,6,5,8,21,29
Cabo Verde,Africa,F,1,1,37,53,90
Mongolia,Asia,F,1,2,36,50,86
Micronesia,Asia,F,1,1,37,56,93
Crimea,Eurasia,NF,7,6,-2,10,8
Kiribati,Asia,F,1,1,36,55,91
Timor-Leste,Asia,F,2,3,33,39,72
Lesotho,Africa,PF,3,3,27,37,64
Sweden,Europe,F,1,1,40,60,100
Tonga,Asia,F,2,2,30,49,79
Paraguay,Americas,PF,3,3,28,37,65
Mozambique,Africa,PF,4,4,19,32,51
Ghana,Africa,F,1,2,37,47,84
Paraguay,Americas,PF,3,3,27,37,64
United Arab Emirates,Middle East,NF,7,6,5,12,17
South Africa,Africa,F,2,2,33,48,81
Croatia,Europe,F,1,2,37,49,86
Greece,Europe,F,1,2,37,50,87
Iran,Middle East,NF,6,6,6,10,16
Indian Kashmir,Asia,PF,4,4,20,29,49
Trinidad and Tobago,Americas,F,2,2,33,49,82
Mozambique,Africa,PF,5,4,14,29,43
Singapore,Asia,PF,4,4,19,32,51
Vanuatu,Asia,F,2,2,33,49,82
West Bank,Middle East,NF,6,5,6,24,30
Western Sahara,Africa,NF,7,7,-3,7,4
China,Asia,NF,7,6,-2,11,9
Tanzania,Africa,PF,3,4,27,33,60
Estonia,Europe,F,1,1,39,56,95
Afghanistan,Asia,NF,6,6,11,16,27
Lesotho,Africa,PF,3,3,27,36,63
Cambodia,Asia,NF,6,5,10,20,30
Paraguay,Americas,PF,3,3,27,35,62
Madagascar,Africa,PF,3,4,24,32,56
Tuvalu,Asia,F,1,1,37,57,94
South Sudan,Africa,NF,7,6,2,12,14
St. Vincent and the Grenadines,Americas,F,1,1,36,55,91
Armenia,Eurasia,PF,5,4,13,29,42
Iraq,Middle East,NF,5,6,12,13,25
Barbados,Americas,F,1,1,38,58,96
Myanmar,Asia,NF,6,6,9,16,25
Australia,Asia,F,1,1,40,57,97
Azerbaijan,Eurasia,NF,7,6,2,9,11
Afghanistan,Asia,NF,7,6,1,9,10
Marshall Islands,Asia,F,1,1,38,55,93
Greece,Europe,F,1,2,36,51,87
Eritrea,Africa,NF,7,7,1,2,3
Mauritania,Africa,NF,6,5,9,21,30
Tajikistan,Eurasia,NF,6,6,7,15,22
South Sudan,Africa,NF,7,6,2,13,15
Western Sahara,Africa,NF,7,7,-2,7,5
San Marino,Europe,F,1,1,40,60,100
Samoa,Asia,F,2,2,31,49,80
Sao Tome and Principe,Africa,F,2,2,34,47,81
Germany,Europe,F,1,1,39,57,96
Chad,Africa,NF,7,6,4,16,20
Gaza Strip,Middle East,NF,6,6,9,10,19
Bolivia,Americas,PF,3,3,25,38,63
Egypt,Africa,NF,6,5,8,18,26
Sweden,Europe,F,1,1,40,59,99
Japan,Asia,F,1,1,40,56,96
Comoros,Africa,PF,3,4,25,30,55
Zimbabwe,Africa,PF,5,5,12,20,32
Nagorno-Karabakh,Eurasia,PF,5,5,12,19,31
Somalia,Africa,NF,7,7,0,2,2
Belize,Americas,F,1,2,36,51,87
Panama,Americas,F,2,2,35,48,83
St. Vincent and the Grenadines,Americas,F,1,1,36,53,89
Central African Republic,Africa,NF,7,7,4,5,9
Kuwait,Middle East,PF,5,5,17,24,41
Abkhazia,Eurasia,PF,4,5,19,23,42
South Africa,Africa,F,2,2,33,48,81
Brazil,Americas,F,2,2,33,48,81
Botswana,Africa,F,3,2,28,46,74
Malawi,Africa,PF,3,3,29,37,66
Belize,Americas,F,1,2,36,50,86
Sweden,Europe,F,1,1,40,60,100
Bahamas,Americas,F,1,1,38,58,96
India,Asia,F,2,3,35,40,75
Nauru,Asia,F,2,2,35,49,84
Brunei,Asia,NF,6,5,7,22,29
Kiribati,Asia,F,1,1,36,55,91
North Macedonia,Europe,PF,4,3,21,37,58
Yemen,Middle East,NF,7,6,1,10,11
Albania,Europe,PF,3,3,28,40,68
Djibouti,Africa,NF,6,5,9,19,28
Peru,Americas,F,2,3,30,41,71
Rwanda,Africa,NF,6,6,8,16,24
Uzbekistan,Eurasia,NF,7,7,0,3,3
Tibet,Asia,NF,7,7,-2,3,1
Yemen,Middle East,NF,7,6,2,12,14
Cabo Verde,Africa,F,1,1,37,53,90
Mexico,Americas,PF,3,3,28,37,65
France,Europe,F,1,1,38,57,95
Ukraine,Eurasia,PF,3,3,25,37,62
Latvia,Europe,F,2,2,35,51,86
Poland,Europe,F,1,1,38,55,93
St. Vincent and the Grenadines,Americas,F,1,1,36,53,89
Solomon Islands,Asia,PF,4,3,22,43,65
Suriname,Americas,F,2,2,33,44,77
Maldives,Asia,PF,5,4,17,29,46
South Africa,Africa,F,2,2,33,46,79
Barbados,Americas,F,1,1,38,58,96
St. Vincent and the Grenadines,Americas,F,1,1,36,54,90
Lebanon,Middle East,PF,5,4,17,32,49
Norway,Europe,F,1,1,40,60,100
Dominican Republic,Americas,PF,3,3,26,41,67
Serbia,Europe,PF,4,3,23,43,66
Peru,Americas,F,2,3,30,41,71
Finland,Europe,F,1,1,40,60,100
Australia,Asia,F,1,1,40,58,98
Cyprus,Europe,F,1,1,37,55,92
New Zealand,Asia,F,1,1,39,58,97
Norway,Europe,F,1,1,40,60,100
Lithuania,Europe,F,1,1,38,53,91
Azerbaijan,Eurasia,NF,7,6,4,10,14
Montenegro,Europe,PF,4,3,22,40,62
Portugal,Europe,F,1,1,39,58,97
Afghanistan,Asia,NF,6,6,11,15,26
Mongolia,Asia,F,1,2,36,49,85
Marshall Islands,Asia,F,1,1,36,55,91
St. Lucia,Americas,F,1,1,39,53,92
Gabon,Africa,NF,7,5,3,19,22
Indonesia,Asia,PF,2,4,30,34,64
Colombia,Americas,PF,3,4,27,34,61
Kuwait,Middle East,PF,5,5,14,23,37
Tanzania,Africa,PF,4,4,22,30,52
Paraguay,Americas,PF,3,3,28,37,65
Argentina,Americas,F,2,2,31,48,79
Mauritania,Africa,NF,6,5,11,21,32
Brazil,Americas,F,2,2,31,47,78
Nigeria,Africa,PF,4,5,18,25,43
Colombia,Americas,PF,3,4,28,34,62
Belgium,Europe,F,1,1,40,57,97
Ecuador,Americas,PF,3,3,25,35,60
Malta,Europe,F,1,1,39,58,97
West Bank,Middle East,NF,6,5,7,24,31
Uruguay,Americas,F,1,1,40,58,98
Western Sahara,Africa,NF,7,7,-3,7,4
Tanzania,Africa,PF,5,5,12,22,34
Somaliland,Africa,PF,4,5,19,24,43
Cameroon,Africa,NF,6,6,9,13,22
Togo,Africa,PF,5,4,15,28,43
Oman,Middle East,NF,6,5,6,17,23
Liberia,Africa,PF,3,4,26,34,60
Tuvalu,Asia,F,1,1,37,57,94
Trinidad and Tobago,Americas,F,2,2,33,48,81
Moldova,Eurasia,PF,3,3,29,35,64
Bahamas,Americas,F,1,1,38,53,91
San Marino,Europe,F,1,1,40,60,100
Indonesia,Asia,F,2,3,30,35,65
Turkey,Europe,NF,5,6,16,16,32
Italy,Europe,F,1,1,37,53,90
Mozambique,Africa,PF,4,4,20,32,52
Lithuania,Europe,F,1,1,38,53,91
Kyrgyzstan,Eurasia,PF,5,4,12,26,38
Australia,Asia,F,1,1,39,58,97
Egypt,Africa,NF,6,6,8,14,22
Latvia,Europe,F,1,2,37,51,88
Sudan,Africa,NF,7,7,3,4,7
Honduras,Americas,PF,4,4,20,31,51
Niger,Africa,PF,3,4,26,30,56
Ukraine,Eurasia,PF,3,4,26,34,60
Indonesia,Asia,PF,2,4,30,31,61
Botswana,Africa,F,3,2,28,44,72
Armenia,Eurasia,PF,5,4,16,29,45
Kazakhstan,Eurasia,NF,7,5,5,17,22
Russia,Eurasia,NF,7,6,5,15,20
Togo,Africa,PF,4,4,18,29,47
Uruguay,Americas,F,1,1,40,57,97
North Macedonia,Europe,PF,3,3,28,39,67
Algeria,Africa,NF,6,5,11,24,35
Congo (Kinshasa),Africa,NF,7,6,4,15,19
Syria,Middle East,NF,7,7,-3,2,-1
Bhutan,Asia,PF,2,4,30,31,61
Cyprus,Europe,F,1,1,37,56,93
Morocco,Africa,PF,5,4,15,27,42
South Ossetia,Eurasia,NF,7,6,2,8,10
Hungary,Europe,PF,3,3,26,43,69
Zambia,Africa,PF,4,4,20,32,52
Bolivia,Americas,PF,3,3,29,38,67
Tajikistan,Eurasia,NF,7,6,0,8,8
St. Kitts and Nevis,Americas,F,1,1,36,53,89
Equatorial Guinea,Africa,NF,7,7,1,7,8
Mexico,Americas,PF,3,3,28,37,65
Comoros,Africa,PF,3,4,24,31,55
Burundi,Africa,NF,6,5,11,21,32
Belgium,Europe,F,1,1,39,57,96
Luxembourg,Europe,F,1,1,38,60,98
Malta,Europe,F,1,1,39,57,96
Lesotho,Africa,PF,3,3,27,36,63
Timor-Leste,Asia,PF,3,4,29,34,63
Vietnam,Asia,NF,7,5,3,17,20
Gabon,Africa,NF,7,5,3,18,21
Singapore,Asia,PF,4,4,19,32,51
Bangladesh,Asia,PF,5,5,15,24,39
North Korea,Asia,NF,7,7,0,3,3
Belarus,Eurasia,NF,7,6,5,15,20
Guinea,Africa,PF,5,5,15,25,40
South Sudan,Africa,NF,7,7,-2,4,2
Togo,Africa,PF,5,4,15,27,42
North Macedonia,Europe,PF,4,3,22,37,59
Antigua and Barbuda,Americas,F,2,2,33,52,85
Fiji,Asia,PF,6,4,7,30,37
Slovenia,Europe,F,1,1,39,55,94
Burundi,Africa,NF,7,6,5,14,19
Congo (Brazzaville),Africa,NF,7,5,2,19,21
Nepal,Asia,PF,3,4,25,31,56
Laos,Asia,NF,7,6,1,11,12
Jordan,Middle East,PF,5,5,12,25,37
Guinea-Bissau,Africa,NF,6,5,9,23,32
Ireland,Europe,F,1,1,39,58,97
Djibouti,Africa,NF,6,5,9,20,29
Switzerland,Europe,F,1,1,39,57,96
Belize,Americas,F,1,2,36,51,87
Haiti,Americas,PF,4,5,18,25,43
Belize,Americas,F,1,2,36,51,87
Chile,Americas,F,1,2,38,52,90
Zambia,Africa,PF,3,4,28,34,62
Timor-Leste,Asia,F,2,3,32,38,70
Abkhazia,Eurasia,PF,4,5,18,22,40
Eswatini,Africa,NF,7,5,1,18,19
Serbia,Europe,F,3,2,28,45,73
Laos,Asia,NF,7,6,0,11,11
Uzbekistan,Eurasia,NF,7,6,2,9,11
Slovakia,Europe,F,1,1,37,53,90
Mauritania,Africa,NF,6,5,9,22,31
Guinea-Bissau,Africa,PF,5,4,15,27,42
Central African Republic,Africa,NF,7,7,0,6,6
Indonesia,Asia,PF,2,4,31,34,65
Thailand,Asia,NF,6,5,6,25,31
Mongolia,Asia,F,1,2,36,50,86
Guatemala,Americas,PF,3,4,24,33,57
Chad,Africa,NF,7,6,1,14,15
Poland,Europe,F,2,2,35,49,84
Azerbaijan,Eurasia,NF,6,6,6,14,20
North Macedonia,Europe,PF,4,3,22,35,57
Malawi,Africa,PF,3,3,27,37,64
Senegal,Africa,F,2,3,32,43,75
Cameroon,Africa,NF,6,6,7,9,16
Suriname,Americas,F,2,2,33,44,77
Taiwan,Asia,F,1,1,37,56,93
Congo (Kinshasa),Africa,NF,6,6,9,16,25
Belarus,Eurasia,NF,7,6,5,14,19
Finland,Europe,F,1,1,40,60,100
Austria,Europe,F,1,1,37,58,95
Bahrain,Middle East,NF,6,6,6,12,18
Papua New Guinea,Asia,PF,4,3,23,39,62
Transnistria,Eurasia,NF,6,6,6,12,18
Niger,Africa,PF,3,4,26,30,56
Oman,Middle East,NF,6,5,6,17,23
Slovenia,Europe,F,1,1,38,53,91
Chad,Africa,NF,7,6,4,14,18
Egypt,Africa,NF,6,6,7,14,21
Monaco,Europe,F,3,1,26,56,82
Bolivia,Americas,PF,3,3,27,39,66
Congo (Brazzaville),Africa,NF,7,5,2,18,20
Oman,Middle East,NF,6,5,8,17,25
Moldova,Eurasia,PF,3,3,26,35,61
South Ossetia,Eurasia,NF,7,6,2,9,11
Denmark,Europe,F,1,1,40,58,98
Palau,Asia,F,1,1,37,55,92
Armenia,Eurasia,PF,5,4,14,29,43
Nicaragua,Americas,NF,7,5,5,18,23
Barbados,Americas,F,1,1,40,59,99
Montenegro,Europe,PF,3,3,24,39,63
Tunisia,Africa,F,1,3,36,42,78
Cyprus,Europe,F,1,1,38,56,94
Sri Lanka,Asia,PF,5,5,16,25,41
Czech Republic,Europe,F,1,1,38,56,94
Iran,Middle East,NF,6,6,7,10,17
Colombia,Americas,PF,3,4,29,34,63
Bolivia,Americas,PF,3,3,28,39,67
